1	1	1	0	2
4	2	6	1	1
1	1	1	0	2
4	3	5	2	9
1	1	1	0	2